..........................
..........................
..@@..@@..@@..@@..@@..@@..
..@@..@@..@@..@@..@@..@@..
..@@..@@..@@..@@..@@..@@..
..@@..@@..@@..@@..@@..@@..
..@@..@@..@@@@@@..@@..@@..
..@@..@@..@@@@@@..@@..@@..
..@@..@@..@@..@@..@@..@@..
..@@..@@..........@@..@@..
..@@..@@..........@@..@@..
..........@@..@@..........
..........@@..@@..........
@@..@@@@..........@@@@..@@
@@..@@@@..........@@@@..@@
..........@@..@@..........
..........@@@@@@..........
..@@..@@..@@@@@@..@@..@@..
..@@..@@..@@..@@..@@..@@..
..@@..@@..@@..@@..@@..@@..
..@@..@@..@@..@@..@@..@@..
..@@..@@..........@@..@@..
..@@..@@..........@@..@@..
..@@..@@...@@@@...@@..@@..
...........#..#...........
...........#..#...........